            uuu          
############fff##########
#                       #
#                 ...   #
#                       #
#          ...          #
#                       #
#                       #
#     ....              #
#                       #
#          Gg   ...     #
#. p       g            #
#.................g..00.#
#########################
                         