            uuu          
############fff##########
#                       #
#                 ...   #
#                       #
#          ...          #
#                       #
#                       #
#     ....              #
#                       #
#               ...     #
#. p                    #
#....................00.#
#########################
                         