################################################################################################################################
#                                                                                                                              #
#                                                                                                                              #
#                                                                                                                              #
#                                                                                                                              #
#                                                                                                                              #
#                                                                                                                              #
#                                                                                                                              #
#                                                                                                                              #
#                                                                                                                              #
#                                                                                                                              #
#                                                                                                                              #
#                                                                                                                              #
#                                                                                                                              #
#                                                                                                                              #
#                                                                                                                              #
#                                                                                                                              #
#                                                                                                                              #
#                                                                                                                              #
#                                                                                                                              #
#                                                                                                                              #
#                                                                                                                              #
#                                                                                                                              #
#                                                                                                                              #
#                                                                                                                              #
#..........              .....                                                                                                 #
#..........                                                                                                                    #
#..........            p                                         .                                                             #
#..........0123...........................................,,,,,,,,............***..............................................#
#..............................................................................................................................#
#..............................................................................................................................#
################################################################################################################################
