#####################
#2222222222fffff2222#
#/                 /#
#/        ,,,      /#
#/                 /#
#/              .../#
#/                 /#
#/         ...     /#
#/                 /#
#/11               /#
#/  ****,,         /#
#/                 /#
#/          ..00   /#
#/                 /#
#/                 /#
#/    ...          /#
#/                 /#
#/        ,,,,     /#
#/                 /#
#...................#
#####################
